111111111111111111111
1P0C001000C000000C001
100000100C00000C00001
100E00111100C00011001
100000000000000000001
111100000010100000001
10010000001C100000001
111111111111111111111