111111
1PC0C1
100001
1C0E11
111111