11111111111111111111
1P0C000000C000001C11
100000000C00000C1111
100E00000000C0000001
11111111111111111111