11111111111111111111
1P0C000000C000000C01
100000000C00000C0001
100E00000000C0000001
11111111111111111111